30 30
0 29
  0  0  0  0  0  0  0 -1  0  0  0  0  0  0  0  0  0  0  0  0  0  0 -1  0  0  0  0  0  0  0
  0 -1  0  0  0  0  0  0  0  0 -1 -1 -1  0  0  0  0  0 -1  0  0  0  0  0 -1  0  0  0  0 -1
  0  0  0  0 -1 -1 -1 -1  0  0  0 -1  0  0  0  0  0  0 -1 -1  0  0  0  0  0  0  0  0  0  0
  0 -1  0  0  0 -1  0  0  0  0  0  0  0  0  0  0 -1  0  0  0  0  0 -1 -1  0 -1  0  0 -1  0
  0  0  0  0  0  0  0  0  0  0  0  0  0 -1  0  0  0  0  0  0 -1  0  0  0 -1  0  0 -1  0  0
  0 -1  0  0  0  0  0  0 -1 -1  0 -1  0  0 -1  0 -1  0 -1  0 -1  0  0  0  0  0  0  0 -1  0
  0 -1  0  0  0  0  0  0  0  0  0  0  0  0  0  0  0  0 -1  0  0  0  0  0 -1  0 -1  0  0  0
  0  0  0  0 -1  0  0 -1  0 -1  0  0  0  0  0  0  0  0 -1  0  0  0  0  0  0  0  0  0 -1 -1
  0 -1  0 -1  0  0  0  0  0  0  0  0  0  0  0  0  0  0  0  0 -1  0 -1  0  0 -1  0  0  0  0
  0  0  0  0 -1  0  0  0  0 -1 -1  0  0  0  0 -1  0  0  0  0  0  0 -1 -1  0  0  0  0  0  0
  0  0  0  0  0  0  0  0 -1  0 -1  0 -1  0 -1  0  0  0 -1  0 -1 -1  0  0 -1  0 -1 -1  0  0
  0  0  0  0  0  0  0  0  0  0  0  0  0  0  0  0  0  0 -1  0  0  0  0  0  0  0  0  0 -1  0
  0  0  0  0  0 -1 -1  0  0  0 -1 -1  0  0  0  0 -1  0  0  0  0  0  0  0  0 -1  0  0  0 -1
  0  0  0  0 -1 -1 -1  0  0  0 -1  0  0  0  0  0  0  0  0  0  0 -1  0  0  0 -1  0  0  0  0
  0  0 -1  0 -1  0  0  0  0  0 -1 -1  0  0  0  0  0  0  0  0  0 -1  0  0  0 -1  0 -1  0 -1
  0  0  0 -1 -1  0  0  0 -1  0  0  0  0  0  0 -1  0  0  0 -1  0  0  0  0  0 -1  0  0 -1  0
 -1  0  0  0  0  0  0  0  0 -1 -1 -1  0  0  0  0  0 -1  0  0  0 -1 -1  0  0  0  0  0  0  0
  0  0  0  0  0  0 -1  0  0  0  0  0  0  0  0  0  0  0  0  0 -1  0  0  0  0  0  0  0 -1  0
  0  0 -1  0 -1 -1  0  0  0  0  0  0  0  0  0  0  0  0  0  0  0  0  0 -1  0  0 -1 -1  0  0
  0  0  0  0  0  0  0  0 -1  0 -1 -1  0 -1  0  0  0  0  0  0  0  0  0  0  0  0  0  0 -1  0
  0  0 -1 -1  0  0  0 -1  0  0 -1  0  0  0  0 -1  0  0 -1  0  0  0  0  0  0  0  0  0  0  0
  0  0  0  0  0  0  0  0  0  0 -1  0  0  0  0  0  0  0 -1  0  0  0  0  0 -1  0  0  0  0  0
  0  0 -1  0 -1  0  0  0  0  0  0  0  0  0 -1  0  0  0  0  0 -1 -1  0  0  0  0  0  0  0  0
  0  0  0  0  0 -1  0 -1  0 -1  0  0 -1  0 -1  0  0  0 -1  0  0  0  0  0  0  0  0  0  0 -1
  0  0 -1  0  0  0  0  0  0 -1  0  0  0  0 -1 -1 -1  0  0  0  0 -1  0  0  0  0  0 -1 -1  0
  0 -1  0  0  0  0  0  0  0  0 -1  0 -1  0  0  0 -1  0  0  0  0  0  0  0  0  0  0  0  0  0
  0 -1  0 -1  0  0  0  0  0  0  0  0  0  0  0  0  0  0  0  0  0  0 -1  0  0  0  0  0  0  0
  0  0  0 -1  0  0  0  0  0  0  0  0  0  0  0  0  0  0  0  0  0  0  0  0  0  0  0  0  0  0
  0 -1  0  0  0 -1  0  0  0 -1  0  0  0  0  0  0 -1  0  0  0 -1  0 -1  0  0  0  0  0  0  0
  0  0  0  0  0 -1 -1  0  0  0  0  0  0  0 -1  0  0  0 -1  0  0  0 -1  0  0  0  0  0  0  0
